S11111111
000000001
111111111
100000000
111111111
000000001
111111111
100000000
11111111K